NO textures/test/NO.png
SO textures/test/SO.png
WE textures/test/WE.png
EA textures/test/EA.png

F 18,53,25
C 153,204,255

11111111111111
1         1101
1       0001
1000000 0011
10S000000001
111111111111
11         1
1111111111111
