NO textures/test/NO.png
SO textures/test/SO.png
WE textures/test/WE.png
EA textures/test/EA.png

F 20,20,20
C 200,200,200

11111111111
10001     1
10S01
10001111111
10001
10000
11001
10001
10001
10001
10001
10001
11111
