NO textures/test/NO.png

   WE    textures/test/WE.png
 SO textures/test/SO.png


EA textures/test/EA.png

    F     18,53,25
C         153,204,255

111
1N11
11111
111111
