   WE                            textures/test/WE.png
NO      textures/test/NO.png



SO textures/test/SO.png

F      17,    38,     64

EA textures/test/EA.png



C 218, 234, 235

11111
10001
1N001
10001
11111
